         NO           textures/wall_n.xpm
    SO                                 textures/wall_s.xpm
   WE     textures/wall_w.xpm
 EA                           textures/wall_e.xpm
            C    150     ,      0       ,      45      
F    69     ,       69       ,         110
                            1111111
                          111110001111
                         110000000011111
                        111000011111111111
                       111001111        111
                 1111111000111           111      
                 11000011000111          111
                 1100001110000111        1111
                 1100001100000111111111111111
                 1100001100000000000000000011
                 1100000100000000000000000001 
                 1100000C0000000W000000000011
                 110000110000000000000000001
                 110001110000000000000000001
                 111111111C00011111111101111
                        1100000111 111100111
                        1100000011  11000111
                        1100000001   1000001
                        1111111111   1111111
