NO textures/wall_n.xpm
SO textures/wall_s.xpm
WE textures/wall_w.xpm
EA textures/wall_e.xpm

C 150 , 0 , 45
F 69 , 69 , 110

1111         1111    1111111111111    1111111111111      111    111    111
11111       11111  11111111111111111  1111       1111    111    111    111
111111     111111  11111       11111  1111         1111  111    111    111
1111111   1111111  11111       11111  1111         1111  111    111    111
11111111 11111111  11111       11111  1111       1111    111    111    111
11111111111111111  11111111111111111  1111111111111      111    111    111
11N1         1111  11111111111111111  111111111111       111    111    111
1111         1111  11111       11111  1111111111111      111    111    111
1111         1111  11111       11111  1111       111     111    111    111
1111         1111  11111       11111  1111        1111   111    111    111
1111         1111  11111       11111  1111         1111  111    111    111
1111         1111  11111       11111  1111         1111  11111111111111111
1111         1111  11111       11111  1111         1111    1111111111111  

  1111111111111    11111        1111          1111       1111
11111111111111111  111111       1111        1111111     1111111
11111       11111  1111111      1111       111111111   111111111
11111       11111  11111111     1111       111111111111111111111
11111       11111  1111 1111    1111        1111111111111111111
11111111111111111  1111  1111   1111         11111111111111111
11111111111111111  1111   1111  1111          111111111111111
11111       11111  1111    1111 1111           1111111111111
11111       11111  1111     11111111            11111111111
11111       11111  1111      1111111             111111111
11111       11111  1111       111111              1111111
11111       11111  1111        11111               11111
11111       11111  1111         1111                111