NO textures/wall_n.xpm
SO textures/wall_s.xpm
EA textures/wall_e.xpm
WE textures/wall_w.xpm

F 220,100,0
C 225,30,0

            1111111111111111111111111
            1000000000110000000000001
            1011000001110000000000001
            1001000000000000000000001
    111111111011000001110000000000001
    100000000011000001110111111111111
    11110111111111011100000010001
111111110111111111011101010010001
10000100000011010101110000001000111
100010000000000000001100000010001
100000000000000000001101010010001
111111000001110101011111010110N011111
    11110111 1111111 101110000001
    11111111         111111111111