NO textures/castle_n.xpm

SO textures/castle_s.xpm
WE textures/castle_w.xpm

C 150,0,45
F 69,69,110

EA textures/castle_e.xpm




 111                                              
 
 111111111111                                     
 100000000001111111111111111111111111             
 100000000000000000000000000000000001             
 100000000001111111111111101111111101111111111111 
 100000000001            101      100000000000001 
 101111111101            101111111101111111111101 
 101      101            100000000001         101 
 101111111101            111111111101         101 
 10000S000001                     101         101 
 100000000001111111111111111111111101         101 
 100000000000000000000000000000000001         101 
 100000000001111111111111111111011111         101 
 111110111111                 101             101 
     101                      101             101 
     101                      1011111111111111101 
     101                      1000000000000000001 
     101                      1111111110111111111 
     101                              101         
     101111111111111111111111111111111101         
     100000000000000000000000000000000001         
     111111111111111111111111111111111111         

